# # # # # # # # # # # # # # # # #
# . . . . . . . . . . . . . . . #
# . . . . . . . . . . . . . . . #
# . . . . . . . . . . . . . . . #
# . . . . . . . . . . . . . . . #
# . . . . . # # # # # . . . . . #
# . . . . . # . . . # . . . . . #
# . . . . . # . T . # . . . . . #
# . . . . . # . . . # . . . . . #
# . . . . . # # - # # . . . . . #
# . . . . . . . . . . . . . . . #
# . . . . . . . . . . . . . . . #
# . . . . . . . . . . . . . . . #
# # # # # # # # # # # # # # # # #